傢	家
價	价
訶	诃
賈	贾
軻	轲
鎵	镓
駕	驾
卻	却
玨	珏
腳	脚
殼	壳
愨	悫
擱	搁
覺	觉
閣	阁
姦	奸
桿	杆
榦	干
幹	干
稈	秆
趕	赶
墾	垦
懇	恳
慳	悭
揀	拣
澗	涧
癇	痫
簡	简
羥	羟
艱	艰
諫	谏
間	间
齦	龈
減	减
尷	尴
鑑	监
監	监
鹼	硷
堿	碱
紺	绀
鑒	鉴
闞	阚
龕	龛
鉀	钾
閘	闸
彊	强
薑	姜
繈	襁
強	强
岡	冈
剛	刚
崗	岗
綱	纲
絳	绛
絳	绦
韁	缰
講	讲
鋼	钢
鏹	镪
蓋	盖
個	个
箇	个
凱	凯
剴	剀
塏	垲
開	开
愾	忾
愷	恺
鈣	钙
鎧	铠
鍇	锴
賡	赓
鏗	铿
據	据
舉	举
櫸	榉
詎	讵
鉅	钜
鋸	锯
乾	干
鍵	键
騫	骞
鶱	骞
傑	杰
儉	俭
劍	剑
撿	捡
檢	检
瞼	睑
臉	脸
鈐	钤
擊	击
緙	缂
繳	缴
覡	觋
闃	阒
堅	坚
牽	牵
筧	笕
縴	纤
絹	绢
繾	缱
繭	茧
見	见
譴	谴
鰹	鲣
鵑	鹃
決	决
潔	洁
結	结
訣	诀
闋	阕
縑	缣
謙	谦
鉗	钳
鶼	鹣
郟	郏
傾	倾
剄	刭
勁	劲
坰	垧
慶	庆
弳	弪
徑	径
驚	惊
氫	氢
涇	泾
烴	烃
瓊	琼
痙	痉
競	竞
經	经
綆	绠
脛	胫
莖	茎
煢	茕
輕	轻
逕	迳
鏡	镜
頃	顷
頸	颈
鯁	鲠
鯨	鲸
係	系
繫	系
啓	启
啟	启
屆	届
繼	继
薊	蓟
計	计
誡	诫
鍥	锲
階	阶
雞	鸡
鷄	鸡
攷	考
僱	雇
薧	槁
庫	库
蠱	蛊
褲	裤
詁	诂
誥	诰
鈷	钴
銬	铐
鋯	锆
錮	锢
顧	顾
鴣	鸪
穀	谷
嚳	喾
轂	毂
鵠	鹄
袞	衮
睏	困
滾	滚
緄	绲
輥	辊
錕	锟
閫	阃
鯀	鲧
鯤	鲲
鶻	鹘
槓	杠
鞏	巩
笻	筇
貢	贡
贛	赣
龔	龚
誇	夸
夥	伙
剮	剐
堝	埚
撾	挝
課	课
過	过
鍋	锅
錁	锞
顆	颗
騍	骒
槨	椁
毌	毋
關	关
寬	宽
慣	惯
摜	掼
綰	绾
觀	观
貫	贯
館	馆
髖	髋
鸛	鹳
颳	刮
鴰	鸹
劻	匡
廣	广
壙	圹
曠	旷
獷	犷
礦	矿
纊	纩
誆	诓
誑	诳
鄺	邝
掛	挂
枴	拐
咼	呙
詿	诖
壞	坏
塊	块
蕢	蒉
幗	帼
摑	掴
蟈	蝈
轟	轰
閎	闳
喬	乔
僑	侨
嚙	啮
嬌	娇
嶠	峤
撟	挢
攪	搅
橋	桥
矯	矫
磽	硗
絞	绞
翹	翘
膠	胶
蕎	荞
蹺	跷
轎	轿
較	较
鉸	铰
餃	饺
驕	骄
鮫	鲛
毬	球
釦	扣
茍	苟
傴	伛
區	区
廄	厩
嘔	呕
夠	够
嫗	妪
屨	屦
嶇	岖
巰	巯
懼	惧
摳	抠
舊	旧
構	构
搆	构
歐	欧
毆	殴
溝	沟
漚	沤
甌	瓯
窶	窭
緱	缑
覯	觏
謳	讴
購	购
賕	赇
軀	躯
釓	钆
鉤	钩
鬮	阄
颶	飓
驅	驱
駒	驹
鳩	鸠
鷗	鸥
鴝	鸲
龜	龟
麯	曲
跼	局
侷	局
挶	局
國	国
鋦	锔
軍	军
皸	皲
詘	诎
宮	宫
窮	穷
捲	卷
踡	蜷
勸	劝
權	权
綣	绻
錈	锩
顴	颧
闕	阙
鱖	鳜
匭	匦
匱	匮
憒	愦
櫃	柜
潰	溃
簣	篑
繢	缋
詭	诡
軌	轨
饋	馈
餽	馈
劌	刿
歸	归
貴	贵
媯	妫
巋	岿
竅	窍
窺	窥
糾	纠
規	规
閨	闺
勻	匀
鈞	钧
剋	克
劇	剧
極	极
棘	枣
巹	卺
觔	筋
僅	仅
覲	觐
謹	谨
饉	馑
錦	锦
伋	汲
級	级
給	给
恆	恒
幾	几
機	机
旂	旗
棄	弃
祇	只
衹	只
衹	致
嘰	叽
豈	岂
榿	桤
氣	气
璣	玑
磯	矶
紀	纪
綺	绮
羈	羁
蘄	蕲
蟣	虮
覬	觊
譏	讥
記	记
頎	颀
飢	饥
饑	饥
騏	骐
騎	骑
驥	骥
鰭	鳍
緊	紧
鮚	鲒
喫	吃
儺	傩
諾	诺
難	难
納	纳
鈉	钠
迺	乃
內	内
釹	钕
撚	捻
寧	宁
嚀	咛
擰	拧
檸	柠
濘	泞
聹	聍
禰	祢
駑	驽
儂	侬
農	农
噥	哝
濃	浓
膿	脓
惱	恼
腦	脑
餒	馁
裊	袅
嬝	袅
鐃	铙
吶	呐
訥	讷
紐	纽
鈕	钮
妳	你
膩	腻
鈮	铌
暱	昵
耑	端
單	单
團	团
糰	团
壇	坛
摶	抟
斷	断
癉	瘅
簞	箪
籪	簖
緞	缎
鄲	郸
鉭	钽
鍛	锻
噠	哒
撻	挞
獺	獭
達	达
鐽	钽
闥	闼
韃	鞑
擔	担
膽	胆
罈	坛
曇	昙
蕁	荨
談	谈
譚	谭
錟	锬
黨	党
儻	傥
當	当
儅	当
噹	当
戇	戆
擋	挡
檔	档
襠	裆
讜	谠
鐺	铛
鏜	镗
餳	饧
臺	台
檯	台
對	对
帶	带
懟	怼
貸	贷
鐓	镦
隊	队
塗	涂
圖	图
導	导
島	岛
搗	捣
擣	捣
濤	涛
燾	焘
盜	盗
禱	祷
縚	绦
賭	赌
鍍	镀
韜	韬
櫝	椟
瀆	渎
牘	牍
犢	犊
獨	独
禿	秃
篤	笃
讀	读
黷	黩
燉	炖
躉	趸
頓	顿
飩	饨
鼕	冬
東	东
凍	冻
動	动
崠	岽
棟	栋
銅	铜
鶇	鸫
鬥	斗
頭	头
竇	窦
鈄	钭
鈍	钝
籐	藤
燈	灯
騰	腾
謄	誊
鄧	邓
鐙	镫
懶	懒
欏	椤
玀	猡
癩	癞
籮	箩
羅	罗
囉	罗
儸	罗
腡	脶
蘿	萝
邏	逻
鑼	锣
鏍	镙
騾	骡
濼	泺
絡	络
犖	荦
鉻	铬
駱	骆
亂	乱
蘭	兰
攔	拦
斕	斓
欄	栏
欒	栾
灤	滦
瀾	澜
爛	烂
讕	谰
鑾	銮
鑭	镧
闌	阑
鸞	鸾
嵐	岚
攬	揽
欖	榄
濫	滥
籃	篮
纜	缆
藍	蓝
襤	褴
覽	览
蠟	蜡
臘	腊
瑯	琅
鋃	锒
閬	阆
崍	崃
徠	徕
來	来
淶	涞
睞	睐
萊	莱
錸	铼
樑	梁
涼	凉
糧	粮
兩	两
倆	俩
諒	谅
輛	辆
魎	魉
麗	丽
侶	侣
儷	俪
勵	励
厲	厉
呂	吕
廬	庐
櫚	榈
濾	滤
癘	疠
礪	砺
糲	粝
臚	胪
慮	虑
蠣	蛎
鋁	铝
閭	闾
驢	驴
驪	骊
鱺	鲡
歷	历
曆	历
嚦	呖
壢	坜
櫪	枥
櫟	栎
瀝	沥
礫	砾
藶	苈
躒	跞
轢	轹
酈	郦
鎘	镉
靂	雳
憐	怜
孌	娈
孿	孪
戀	恋
攣	挛
攆	撵
漣	涟
煉	炼
璉	琏
練	练
聯	联
臠	脔
蓮	莲
褳	裢
輦	辇
連	连
鍊	链
鏈	链
鰱	鲢
鋝	锊
奩	奁
簾	帘
斂	敛
殮	殓
瀲	潋
薟	莶
蘞	蔹
鐮	镰
獵	猎
嶺	岭
欞	棂
櫺	棂
靈	灵
鈴	铃
領	领
齡	龄
隸	隶
禮	礼
鱧	鳢
勞	劳
盧	卢
鹵	卤
滷	卤
嘮	唠
嚕	噜
壚	垆
蘆	芦
嶗	崂
撈	捞
擄	掳
擼	撸
櫨	栌
櫓	橹
艣	橹
氌	氇
瀘	泸
澇	涝
爐	炉
癆	痨
艫	舻
虜	虏
轤	轳
輅	辂
銠	铑
鐒	铹
顱	颅
魯	鲁
鱸	鲈
鸕	鸬
鷺	鹭
錄	录
淥	渌
祿	禄
綠	绿
轆	辘
論	论
嚨	咙
壟	垄
攏	拢
櫳	栊
瀧	泷
瓏	珑
礱	砻
籠	笼
聾	聋
朧	胧
蘢	茏
隴	陇
瀨	濑
籟	籁
誄	诔
賂	赂
賚	赉
賴	赖
鐳	镭
暸	了
瞭	了
療	疗
繚	缭
遼	辽
鐐	镣
鬧	闹
鷯	鹩
矓	胧
龍	龙
僂	偻
嘍	喽
壘	垒
婁	娄
屢	屡
嶁	嵝
摟	搂
樓	楼
淚	泪
瘺	瘘
簍	篓
縷	缕
耬	耧
蔞	蒌
螻	蝼
褸	褛
鏤	镂
髏	髅
纍	累
霤	溜
劉	刘
瀏	浏
類	类
綹	绺
縲	缧
謬	谬
鉚	铆
鎦	镏
餾	馏
騮	骝
鷚	鹨
僇	戮
陸	陆
侖	仑
崙	仑
倫	伦
圇	囵
掄	抡
淪	沦
綸	纶
輪	轮
慄	栗
扐	仂
鰳	鳓
凜	凛
廩	廪
懍	檩
檁	檩
蔆	菱
稜	棱
綾	绫
鯪	鲮
釐	厘
離	离
貍	狸
裡	里
裏	里
浬	里
灕	漓
犛	犁
蒞	莅
籬	篱
縭	缡
蘺	蓠
邐	逦
鋰	锂
鯉	鲤
鸝	鹂
燐	磷
藺	蔺
躪	躏
轔	辚
鄰	邻
鱗	鳞
痳	麻
臨	临
痲	麻
麼	麽
麽	么
嗎	吗
嘜	唛
媽	妈
嬤	嬷
榪	杩
瑪	玛
碼	码
螞	蚂
馬	马
鏌	镆
饃	馍
輓	挽
萬	万
巒	峦
彎	弯
懣	懑
灣	湾
滿	满
瞞	瞒
縵	缦
蠻	蛮
謾	谩
鏝	镘
顢	颟
饅	馒
鰻	鳗
襪	袜
網	网
輞	辋
買	买
勱	劢
賣	卖
邁	迈
罵	骂
脈	脉
驀	蓦
麥	麦
錳	锰
冪	幂
覓	觅
麵	面
綿	绵
緬	缅
衊	蔑
滅	灭
銘	铭
鳴	鸣
謀	谋
謨	谟
糢	馍
鉬	钼
鶩	鹜
歿	殁
沒	没
濛	蒙
懞	蒙
矇	蒙
夢	梦
貓	猫
廟	庙
緲	缈
錨	锚
無	无
畝	亩
務	务
嘸	呒
嫵	妩
廡	庑
憮	怃
撫	抚
繆	缪
蕪	芜
誣	诬
貿	贸
霧	雾
騖	骛
鵡	鹉
們	们
抆	擦
捫	扪
紋	纹
鍆	钔
門	门
問	问
聞	闻
閿	阌
黴	霉
彌	弥
瀰	弥
獼	猕
瞇	眯
羋	芈
謎	谜
鎂	镁
憫	悯
澠	渑
燜	焖
緡	缗
閔	闵
悶	闷
閩	闽
黽	黾
謐	谧
樸	朴
撲	扑
剝	剥
縛	缚
釙	钋
鉑	铂
鏷	镤
颮	飑
駁	驳
闆	板
盤	盘
槃	盘
礬	矾
絆	绊
蹣	蹒
頒	颁
飯	饭
發	发
髮	发
撥	拨
潑	泼
缽	钵
鈸	钹
餑	饽
鵓	鹁
踫	碰
倣	仿
徬	旁
幫	帮
龐	庞
紡	纺
綁	绑
訪	访
謗	谤
鈁	钫
鎊	镑
魴	鲂
揹	背
賠	赔
輩	辈
煩	烦
罰	罚
閥	阀
氾	泛
汎	泛
範	范
釩	钒
琺	珐
蘗	蘖
闢	辟
變	变
抃	拚
籩	笾
辯	辩
辮	辫
邊	边
別	别
彆	别
癟	瘪
鱉	鳖
並	并
併	并
餅	饼
駢	骈
寶	宝
報	报
補	补
譜	谱
輔	辅
鐠	镨
鴇	鸨
蔔	卜
僕	仆
複	复
輻	辐
鰒	鳆
鳳	凤
縫	缝
鋒	锋
伕	夫
鳧	凫
復	复
婦	妇
膚	肤
訃	讣
負	负
賦	赋
賻	赙
駙	驸
鮒	鲋
麩	麸
僨	偾
噴	喷
墳	坟
奮	奋
憤	愤
糞	粪
紛	纷
賁	贲
錛	锛
彿	佛
紱	绂
紼	绋
繃	绷
鵬	鹏
祕	秘
痺	痹
屝	扉
備	备
憊	惫
疿	痱
箄	箅
紕	纰
緋	绯
羆	罴
誹	诽
費	费
轡	辔
鐨	镄
飛	飞
鯡	鲱
儐	傧
蘋	苹
嬪	嫔
賓	宾
擯	摈
檳	槟
殯	殡
濱	滨
瀕	濒
繽	缤
臏	膑
貧	贫
鑌	镔
頻	频
顰	颦
髕	髌
鬢	鬓
憑	凭
騁	骋
捨	舍
簑	蓑
絲	丝
寫	写
厙	厍
皻	隳
師	师
瀉	泻
獅	狮
篩	筛
紗	纱
螄	蛳
詐	诈
詞	词
謝	谢
賒	赊
賜	赐
辭	辞
鉈	铊
飼	饲
駛	驶
駟	驷
鯊	鲨
鷥	鸶
爍	烁
鑠	铄
痠	酸
產	产
傘	伞
刪	删
姍	姗
訕	讪
剷	铲
鏟	铲
閂	闩
殺	杀
薩	萨
滲	渗
毿	毵
糝	糁
釤	钐
澀	涩
鍤	锸
颯	飒
喪	丧
傷	伤
償	偿
廂	厢
嘗	尝
殤	殇
狀	状
緗	缃
觴	觞
詳	详
賞	赏
顙	颡
璽	玺
賽	赛
鰓	鳃
嗇	啬
穡	穑
賾	赜
銫	铯
棲	栖
書	书
敘	叙
嶼	屿
紓	纾
緒	绪
鋤	锄
潟	泻
碩	硕
釋	释
錫	锡
亙	亘
鏇	旋
嬋	婵
獮	猕
癬	癣
禪	禅
秈	籼
線	线
繕	缮
羨	羡
蘚	藓
蟬	蝉
詵	诜
躚	跹
選	选
銑	铣
鏇	镟
騸	骟
鮮	鲜
鱔	鳝
洩	泄
抴	曳
褻	亵
齧	啮
紲	绁
設	设
說	说
鱈	鳕
摻	掺
殲	歼
纖	窍
纖	纤
譫	谵
贍	赡
閃	闪
陝	陕
囁	嗫
懾	慑
攝	摄
灄	滠
聶	聂
躡	蹑
鑷	镊
顳	颞
聖	圣
聲	声
誠	诚
鋮	铖
勢	势
歲	岁
稅	税
細	细
貰	贳
篠	筱
嘯	啸
掃	扫
瀟	潇
燒	烧
穌	稣
簫	箫
紹	绍
繅	缫
甦	苏
蘇	苏
囌	苏
蕭	萧
訴	诉
銷	销
騷	骚
屬	属
續	续
謖	谡
贖	赎
孫	孙
損	损
猻	狲
蓀	荪
遜	逊
鬆	松
訟	讼
誦	诵
鍶	锶
頌	颂
灑	洒
嗩	唢
曬	晒
瑣	琐
鎩	铩
鎖	锁
釗	钊
脩	修
獸	兽
壽	寿
帥	帅
擻	擞
數	数
樹	树
豎	竖
繡	绣
綏	绥
綬	绶
藪	薮
雖	虽
誰	谁
誶	谇
輸	输
銖	铢
銹	锈
鏽	锈
鎪	锼
隨	随
讎	雠
須	须
鬚	须
颼	飕
餿	馊
饈	馐
肅	肃
脣	唇
筍	笋
純	纯
詢	询
諄	谆
順	顺
馴	驯
鶉	鹑
卹	恤
術	术
習	习
濕	湿
溼	湿
襲	袭
繩	绳
勝	胜
蠅	蝇
廝	厮
弒	弑
塒	埘
時	时
緦	缌
蒔	莳
視	视
試	试
詩	诗
釃	酾
鈰	铈
鰣	鲥
蝕	蚀
識	识
軾	轼
飾	饰
燼	烬
紳	绅
腎	肾
藎	荩
訊	讯
贐	赆
實	实
瀋	沈
嬸	婶
審	审
尋	寻
潯	浔
瀋	渖
諗	谂
諶	谌
鐔	镡
鱘	鲟
雙	双
亞	亚
兒	儿
啞	哑
婭	娅
椏	桠
氬	氩
訝	讶
鈳	钶
錒	锕
餓	饿
鴉	鸦
鵝	鹅
嶽	岳
樂	乐
堊	垩
惡	恶
諤	谔
鍔	锷
顎	颚
鱷	鳄
鶚	鹗
齷	龌
贗	赝
銨	铵
頇	顸
顏	颜
訐	讦
謁	谒
軋	轧
閼	阏
巖	岩
菴	庵
嵒	岩
諳	谙
鵪	鹌
壓	压
鴨	鸭
鴦	鸯
礙	碍
噯	嗳
嬡	嫒
曖	暧
愛	爱
璦	瑷
皚	皑
藹	蔼
閡	阂
靄	霭
阨	厄
縊	缢
軛	轭
額	额
嚶	嘤
櫻	樱
罌	罂
鶯	莺
鸚	鹦
爺	爷
籥	龠
喲	哟
約	约
葯	药
藥	药
躍	跃
鑰	钥
孃	娘
癢	痒
養	养
颺	扬
揚	扬
楊	杨
樣	样
煬	炀
瘍	疡
讓	让
釀	酿
鑲	镶
瓖	镶
陽	阳
暘	阳
驤	骧
禦	御
漁	渔
語	语
飫	饫
馭	驭
魚	鱼
齬	龉
億	亿
憶	忆
鼴	鼹
彥	彦
牪	瘪
諺	谚
讞	谳
鎳	镍
隉	陧
嚴	严
儼	俨
醃	腌
釅	酽
閹	阉
業	业
鄴	邺
餘	余
與	与
歟	欤
畬	畲
輿	舆
蕷	蓣
銣	铷
睪	睾
嶧	峄
懌	怿
繹	绎
譯	译
閾	阈
驛	驿
縯	演
煙	烟
嚥	咽
兗	兖
櫞	橼
淵	渊
硯	砚
緣	缘
軟	软
鉛	铅
鳶	鸢
悅	悦
熱	热
閱	阅
燄	焰
厭	厌
厴	厣
懨	恹
鹽	盐
艷	艳
豔	艳
閆	闫
閻	阎
饜	餍
魘	魇
鯰	鲶
葉	叶
曄	晔
燁	烨
靨	靥
詠	咏
嬰	婴
嶸	嵘
攖	撄
獰	狞
瓔	璎
癭	瘿
纓	缨
塋	茔
榮	荣
營	营
縈	萦
蠑	蝾
贏	赢
潁	颍
穎	颖
囈	呓
瘞	瘗
穢	秽
藝	艺
譽	誉
詣	诣
銳	锐
預	预
鯢	鲵
杇	圬
烏	乌
吳	吴
嗚	呜
塢	坞
埡	垭
奧	奥
娛	娱
噁	恶
汙	污
襖	袄
誤	误
鄔	邬
鎢	钨
驁	骜
鰲	鳌
鼇	鳌
獄	狱
鈺	钰
媼	媪
慍	愠
氳	氲
溫	温
穩	稳
蘊	蕴
醞	酝
醖	酝
韞	韫
膃	腽
甕	瓮
擁	拥
癰	痈
廱	痈
窪	洼
臥	卧
枙	栀
渦	涡
窩	窝
萵	莴
蝸	蜗
訛	讹
緩	缓
頑	顽
媧	娲
聵	聩
僥	侥
祅	祆
嬈	娆
堯	尧
擾	扰
撓	挠
搖	摇
橈	桡
澆	浇
瑤	瑶
窯	窑
繞	绕
蕘	荛
蟯	蛲
謠	谣
遙	遥
銚	铫
饒	饶
鰩	鳐
鷂	鹞
縟	缛
鵒	鹆
鎔	熔
踴	踊
湧	涌
傭	佣
聳	耸
鏞	镛
俁	俣
祐	佑
優	优
憂	忧
慪	怄
紆	纡
郵	邮
魷	鱿
齲	龋
勗	勖
頊	顼
雲	云
韻	韵
蕓	芸
惲	恽
殞	殒
抎	殒
紜	纭
運	运
鄆	郓
鄖	郧
隕	陨
鬱	郁
願	愿
員	员
園	园
圓	圆
諢	诨
轅	辕
遠	远
鴛	鸳
黿	鼋
粵	粤
鉞	钺
戉	钺
為	为
偉	伟
偽	伪
衛	卫
餵	喂
圍	围
幃	帏
溈	沩
潿	涠
煒	炜
瑋	玮
緯	纬
葦	苇
諉	诿
謂	谓
違	违
闈	闱
韋	韦
韙	韪
籲	吁
遊	游
崳	嵛
濰	潍
猶	犹
維	维
蕕	莸
覦	觎
誘	诱
諛	谀
諭	谕
遺	遗
鈾	铀
銪	铕
鮪	鲔
潤	润
閏	闰
絨	绒
慇	殷
癮	瘾
銀	银
隱	隐
釔	钇
蔭	荫
陰	阴
飲	饮
應	应
鷹	鹰
義	义
儀	仪
醫	医
擬	拟
艤	舣
蟻	蚁
議	议
誼	谊
銥	铱
鐿	镱
爾	尔
迆	迤
異	异
詒	诒
貳	贰
貽	贻
邇	迩
鉺	铒
頤	颐
飴	饴
餌	饵
鮞	鲕
鴯	鸸
謚	谥
紉	纫
認	认
軔	轫
銦	铟
韌	韧
鎰	镒
賃	赁
飪	饪
眥	眦
藉	借
茲	兹
玆	兹
諮	谘
貲	赀
資	资
鋅	锌
鶿	鹚
鷓	鹧
綽	绰
鵲	鹊
棧	栈
殘	残
盞	盏
驏	骣
潛	潜
蠶	蚕
暫	暂
賺	赚
雜	杂
裝	装
莊	庄
場	场
墻	墙
牆	墙
壯	壮
奬	奖
獎	奖
妝	妆
嬙	嫱
將	将
帳	帐
張	张
槳	桨
樁	桩
檣	樯
漿	浆
腸	肠
臟	脏
髒	脏
萇	苌
蔣	蒋
薔	蔷
賬	账
贓	赃
贜	赃
醬	酱
鏘	锵
長	长
駔	驵
纔	才
災	灾
齋	斋
財	财
載	载
齜	龇
爭	争
崢	峥
掙	挣
鎗	枪
猙	狰
箏	筝
諍	诤
錚	铮
藷	薯
牴	抵
豬	猪
佇	伫
儲	储
著	着
櫧	槠
苧	苎
詛	诅
詆	诋
貯	贮
這	这
齟	龃
適	适
跡	迹
墑	墒
敵	敌
磧	碛
勣	积
積	积
糴	籴
績	绩
覿	觌
謫	谪
賊	贼
鏑	镝
澱	淀
專	专
傳	传
囀	啭
巔	巅
戔	戋
戰	战
戩	戬
氈	毡
電	电
癲	癫
磚	砖
箋	笺
縳	缚
纏	缠
靦	腼
詮	诠
轉	转
輇	辁
輾	辗
錢	钱
鈿	钿
鐉	铣
銓	铨
鐫	镌
闐	阗
顓	颛
顛	颠
顫	颤
餞	饯
竊	窃
癤	疖
絕	绝
節	节
唸	念
佔	占
點	点
霑	沾
墊	垫
漸	渐
摺	折
鰈	鲽
偵	侦
淨	净
凈	净
幀	帧
棖	枨
檉	柽
楨	桢
湞	浈
睜	睁
禎	祯
蟶	蛏
訂	订
貞	贞
鄭	郑
釘	钉
鉦	钲
鋌	铤
錠	锭
靚	靓
靜	静
頂	顶
隄	堤
製	制
儕	侪
劑	剂
嚌	哜
擠	挤
濟	济
綈	绨
緹	缇
臍	脐
薺	荠
蠐	蛴
諸	诸
躋	跻
銻	锑
際	际
霽	霁
題	题
鱭	鲚
鵜	鹈
齊	齐
齏	齑
弔	吊
彫	雕
譟	噪
條	条
棗	枣
竈	灶
糶	粜
組	组
絛	绦
繰	缲
蔦	茑
詔	诏
調	调
趙	赵
釕	钌
釣	钓
鰷	鲦
鯛	鲷
鳥	鸟
鏃	镞
蹤	踪
從	从
慫	怂
樅	枞
種	种
縱	纵
終	终
綜	综
腫	肿
鐘	钟
鍾	锺
銼	锉
週	周
註	注
硃	朱
冑	胄
丟	丢
儔	俦
湊	凑
廚	厨
幬	帱
晝	昼
櫥	橱
疇	畴
籌	筹
紂	纣
綢	绸
誅	诛
躊	踌
躕	蹰
輳	辏
銩	铥
鑄	铸
駐	驻
準	准
雋	隽
駿	骏
鱒	鳟
眾	众
衆	众
鯽	鲫
櫛	栉
騭	骘
繒	缯
証	证
證	证
贈	赠
扺	抵
誌	志
阯	址
遲	冲
摯	挚
漬	渍
紙	纸
贄	贽
躓	踬
軹	轵
輊	轾
遲	迟
鷙	鸷
織	织
職	职
晉	晋
塵	尘
盡	尽
儘	尽
縉	缙
縝	缜
診	诊
賑	赈
軫	轸
進	进
鎮	镇
陣	阵
陳	陈
姪	侄
質	质
軼	轶
鴆	鸩
執	执
縶	絷
緝	缉
輯	辑
徵	征
癥	症
懲	惩
扠	叉
硨	砗
車	车
鹺	鹾
鑿	凿
諑	诼
錯	错
齪	龊
巑	漓
攛	撺
攢	攒
燦	灿
瓚	瓒
竄	窜
纘	缵
讚	赞
贊	赞
趲	趱
躥	蹿
躦	躜
鑽	钻
饌	馔
剎	刹
偺	咱
鍘	铡
參	参
塹	堑
嶄	崭
懺	忏
慘	惨
慚	惭
攙	搀
斬	斩
槧	椠
磣	碜
讒	谗
譖	谮
讖	谶
鏨	錾
饞	馋
驂	骖
黲	黪
倉	仓
倀	伥
傖	伧
創	创
廠	厂
嗆	呛
悵	怅
愴	怆
戧	戗
搶	抢
槍	枪
滄	沧
漲	涨
熗	炝
暢	畅
瘡	疮
脹	胀
艙	舱
蒼	苍
蹌	跄
錆	锖
閶	阊
鯧	鲳
債	债
綵	彩
採	采
蠆	虿
釵	钗
冊	册
嘖	啧
幘	帻
柵	栅
簀	箦
責	责
悽	凄
淒	凄
處	处
覷	觑
隻	只
蹠	跖
呎	尺
慼	戚
齣	出
擲	掷
滌	涤
躑	踯
韆	千
薦	荐
囅	冁
淺	浅
濺	溅
蕆	蒇
賤	贱
踐	践
遷	迁
釧	钏
闡	阐
韉	鞯
徹	彻
綴	缀
輟	辍
轍	辙
鐵	铁
鋨	锇
僉	佥
簷	檐
簽	签
籤	签
襝	裣
覘	觇
諂	谄
疊	叠
諜	谍
貼	贴
輒	辄
鉆	钻
聽	听
廳	厅
請	请
鯖	鲭
體	体
屜	屉
滯	滞
締	缔
諦	谛
遞	递
勦	剿
岧	迢
礎	础
綃	绡
艸	艹
謅	诌
誚	诮
譙	谯
軺	轺
鈔	钞
鍬	锹
鷦	鹪
齠	龆
囑	嘱
燭	烛
矚	瞩
觸	触
吋	寸
叢	丛
傯	偬
蔥	葱
寵	宠
總	总
聰	聪
蓯	苁
銃	铳
驄	骢
脧	睃
芻	刍
鞦	秋
醜	丑
墜	坠
樞	枢
皺	皱
縐	绉
縋	缒
諏	诹
趨	趋
鄒	邹
錘	锤
錐	锥
雛	雏
騶	驺
騅	骓
鯫	鲰
鰍	鳅
築	筑
縮	缩
軸	轴
朮	术
絀	绌
沖	冲
衝	冲
蟲	虫
贅	赘
驟	骤
鷲	鹫
側	侧
庂	仄
廁	厕
惻	恻
測	测
櫬	榇
齔	龀
層	层
緻	致
癡	痴
幟	帜
梔	栀
熾	炽
緇	缁
恥	耻
觶	觯
輜	辎
錙	锱
馳	驰
鯔	鲻
鴟	鸱
齒	齿
則	则
飭	饬
親	亲
襯	衬
寢	寝
針	针
鋟	锓
蟄	蛰
稱	称
儈	侩
噲	哙
墮	堕
橢	椭
綞	缍
詫	诧
鍺	锗
馱	驮
駝	驼
鴕	鸵
鼉	鼍
託	托
濁	浊
籜	箨
鐸	铎
鐲	镯
歎	叹
嘆	叹
彈	弹
憚	惮
撣	掸
攤	摊
殫	殚
灘	滩
瘓	痪
癱	瘫
綻	绽
誕	诞
奪	夺
脫	脱
撢	掸
貪	贪
賧	赕
鰨	鳎
湯	汤
燙	烫
碭	砀
蕩	荡
盪	荡
鐋	铴
兌	兑
颱	台
態	态
紿	绐
蛻	蜕
鈦	钛
駘	骀
鮐	鲐
擇	择
澤	泽
撐	撑
攄	摅
討	讨
釷	钍
噸	吨
慟	恸
統	统
頹	颓
囪	囱
鋱	铽
闖	闯
擺	摆
罷	罢
鈀	钯
頗	颇
辦	办
販	贩
鈑	钣
唄	呗
壩	坝
珮	佩
狽	狈
貝	贝
敗	败
鋇	钡
緶	缏
編	编
諞	谝
騙	骗
貶	贬
評	评
幣	币
廢	废
斃	毙
閉	闭
鉋	刨
鑤	刨
砲	炮
佈	布
拋	抛
皰	疱
鈽	钸
鋪	铺
飽	饱
鮑	鲍
齙	龅
錶	表
標	标
縹	缥
鏢	镖
鑣	镳
飄	飘
飆	飙
驃	骠
鰾	鳔
稟	禀
豐	丰
馮	冯
楓	枫
灃	沣
瘋	疯
諷	讽
風	风
襬	摆
鈹	铍
嗶	哔
畢	毕
潷	滗
筆	笔
篳	筚
蓽	荜
蹕	跸
鉍	铋
鵯	鹎
廈	厦
芐	苄
蝦	虾
賀	贺
學	学
澩	泶
瘧	疟
謔	谑
鶴	鹤
嫻	娴
捍	扞
漢	汉
銲	焊
釬	钎
閑	闲
閒	闲
韓	韩
鷳	鹇
鷴	鹇
轄	辖
鹹	咸
檻	槛
緘	缄
艦	舰
啣	衔
銜	衔
頷	颔
餡	馅
郃	合
閤	合
闔	阖
陜	陕
頜	颌
鴿	鸽
骯	肮
鈧	钪
閌	闶
項	项
頏	颃
該	该
諧	谐
賅	赅
頦	颏
駭	骇
鮭	鲑
覈	核
倖	幸
絎	绗
鄉	乡
響	响
嚮	向
薌	芗
饗	飨
餉	饷
噓	嘘
虛	虚
許	许
憲	宪
搟	擀
獻	献
軒	轩
獫	猃
險	险
驗	验
嚇	吓
鬩	阋
縣	县
絃	弦
峴	岘
懸	悬
顯	显
現	现
絢	绚
莧	苋
蜆	蚬
賢	贤
鉉	铉
頁	页
俠	侠
協	协
夾	夹
峽	峡
愜	惬
挾	挟
浹	浃
狹	狭
硤	硖
篋	箧
脅	胁
莢	荚
蛺	蛱
鋏	铗
鉿	铪
頰	颊
瀅	滢
瀠	潆
荊	荆
滎	荥
熒	荧
瑩	莹
螢	萤
鎣	蓥
陘	陉
號	号
壺	壶
鬍	胡
戶	户
護	护
滬	沪
滸	浒
灝	灏
縞	缟
蠔	蚝
鎬	镐
顥	颢
鶘	鹕
渾	浑
琿	珲
閽	阍
餛	馄
鬨	哄
紅	红
葒	荭
訌	讧
鴻	鸿
華	华
嘩	哗
樺	桦
畫	画
禍	祸
話	话
貨	货
鈥	钬
鏵	铧
驊	骅
確	确
擴	扩
穫	获
鑊	镬
喚	唤
奐	奂
汍	丸
換	换
歡	欢
渙	涣
煥	焕
環	环
紈	纨
繯	缳
還	还
鍰	锾
鯇	鲩
鰥	鳏
闊	阔
況	况
謊	谎
貺	贶
鰉	鳇
黃	黄
噦	哕
會	会
劊	刽
迴	回
佪	徊
懷	怀
檜	桧
匯	汇
澮	浍
燴	烩
獪	狯
繪	绘
膾	脍
薈	荟
詼	诙
誨	诲
賄	贿
鄶	郐
劃	划
獲	获
橫	横
黌	黉
嘵	哓
囂	嚣
餚	肴
曉	晓
梟	枭
驍	骁
後	后
詬	诟
詡	诩
鱟	鲎
勛	勋
塤	埙
壎	埙
暈	晕
葷	荤
訓	训
諼	谖
燬	毁
毀	毁
揮	挥
暉	晖
彙	汇
諱	讳
輝	辉
虧	亏
攜	携
鵂	鸺
譎	谲
鷸	鹬
兇	凶
洶	汹
訢	欣
釁	衅
扢	扦
紇	纥
訖	讫
撳	揿
欽	钦
興	兴
晞	曦
戲	戏
犧	牺
誒	诶
餼	饩
擷	撷
纈	缬
詰	诘
頡	颉